11111111111111111111111111111
11110000000C11110000000C11001
1000000C000000E00000011C00001
10000000000000000000000000001
10000000C00000000000001111111
1000000000000C000000000000001
10000000000000000000000000001
1000000000000000000C000000001
11111111111111111111111111111
