11111111111111111111111111111
11110000000011110000000011001
1000000P000000E00000011000001
10000000000000000000000000001
10000000000000000000001111111
10000000000000000000000000001
10000000000000000000000000001
10000000000000000000000000001
11111111111111111111111111111
